OOOOOOOOOOOOOOOOOOOOOOOO
O1OOOOOOOOOOOOOOOOOOOOOO
FGGHOOOOOOFGGHOOOOOOOOOO
TTTUOOOOOOXTTUOOOOOOOOOO
TTTUFGHOOOOOOOOOOOOO2OOO
TTTTTTUFGGHOOFGGGGGGGGGH
TTTTTTTTTTUFHXTTTTTTTTTT
TTTTTTTTTTTTTTTTTTTTTTTT
